####################
#       x          #
#                  #
#                  #
#              #####
#                  #
#                  #
#       a          #
#                  #
#                  #
#                  #
#                  #
#                  #
#                  #
#                  #
#                  #
#                  #
####               #
# o                #
#                  #
#                  #
####################