##########
#    x   #
#        #
#     ####
#        #
#    a   #
#        #
####     #
#        #
##########